GGGGGGGGGGGGGGGGGGGGG
GGGGGGGGGGGGGGGGGGGGG
WWWWWWWWWWWWWWWWWWWWW
VVVVVGRGGGGGGGGGGGGGG
GGGVVRGGGGGGGGGGGGGGG
GGGVVGGGGRGGGGGGGGGGP
GGGVVGGGGGGGDGGGGGGGG
GGGGGGGGGGGGGGGGGGGGG
GGGGGGGGDGGGGGGGDGGEG
RRRGVGGGRGGGGGGGGGGGG
GGGGVGRGGGGGGGRGGVVVV
