51
28
WWWWWWWWWWWWWWWWWWWWWWWWWWWWWWWWWWWWWWWWWWWWWWWWWWW
WGRGRGGWGRGDGGGGWGGGGGGGGVGGGGGGRGWVGGGGGGGWGGGRRGW
WGGPGGGWGGGGGGGGWGGGGGGGGVGGGGGGGGWVGGGGGGGWGGGGGGW
WGGGGGGWGGGGGGGVWVVGGGGGGVGGGGGGGGWVGVGGGGGWGGGGGVW
WVVVVVVVVVVVVVVRVVVVVVVVVVVVVVVVVVVRVDVVVVVVVVVVVRW
WDGGGGGWGRGGGGGRWGRGGGGGGVGGGGGGGVWGGGGDGGGWGGGRGRW
WGGGGGGWGRGGGGGGWGRGGGGGGVGGGGGGGGWGGGGGGGGWGGGGGGW
WWWWWWWWWWWWWWWWWWWWWWWWWVWWWWWWWWWWWWWWWWWWWWWWWWW
WGGVVGGWGVGGGGGGWGGGGGGGGVGGGGGGGRWGGGGGGGGWGGGGGVW
WGGRRGGWGVGGGGGGWGGGGGGGGVGGGGGGGGWGGGGGGGGWGGGGGVW
WGGGGGGWGVGGGGGGWGGGGGGGGVGGGGGGGGWGGGGGGGGWGGGGGRW
WVVVVVVVVRVVVVVVVVVVVVVVVVVVVVVVVVVVVVVVVVVVVVVVVRW
WGRGGGGWGGGGRGGGWGRGGGGGRRGGGGGGGDWGGGGGDGGWVGGGGGW
WRGGRGGWGGGGGRGGWGVGGGGGGRGRRRGGGGWGGGGRGRGWVGGGVGW
WRGGGGGWGGGRDGGGWGDGGGGGGVGVVVGGGGWGGGGGGGGWRGGGRGW
WGRGGGGWGGGGRGGGWGRGGGGGGVGVVVGGGGWGGGGGGGGWRRGGRGW
WWWWWWWWWWWWWWWWWWWWWWWWWVWWWWWWWWWWWWWWWWWWWWWWWWW
WRGVEVGWGGGGRGRGWGGGGGGGGVGGGGGGGGWGRDGGVGGWGGGGGGW
WGGGGGVWGGGGGGGGWGGGGGGGGVGGGGGGGGWGGGVGRGGWGGGGGGW
WGGGGGVWGGGGGGGGWGGGGGGGDVGGVGGVGGWGGGVGRGGWVGVVGGW
WVVVVVVVRVVVVVVVVVVVVVVVVVVVVVVVVVVVVVRVRVVVRVRRVVW
WGGGGRGWRGGGGRGGWGGDGGGGGVGGGGGGGRWGGGRGGGGWGGGGGGW
WDGGGRGWRGGDGGGGWGGGGGGGGVVGGGGGGGWGGGGRGGGWGGGVVVW
WGGGGRGWRGGGGGGGWGGVVDGGGVRGGRGGGGWGGGGGGGGWGGGVVVW
WGGGGRGWGGVGGGGGWGGGGGGGGVGGGGGGGGWGGGVGGGGWGGGRRRW
WDGGGGRWGGVGGGGGWGGGGGGGGVDGGGGGGGWGGGGGGGGWGGGGRGW
WRGGGGGWGGRGGGGGWGGEGGGGGVGGGGGGGGWGGGGGGRRWGGGGGGW
WWWWWWWWWWWWWWWWWWWWWWWWWWWWWWWWWWWWWWWWWWWWWWWWWWW

	
