51
28
WWWWWWWWWWWWWWWWWWWWWWWWWWWWWWWWWWWWWWWWWWWWWWWWWWW
WRWWDWGGGGGGGGRWRGRGGGGGGGGGGGGGGGGGGGGGGGGGGGGGDGW
WGPWGGGRGGGGGGWWWGWGRGGGGGGRGGGGGGGGGGGGGGGGGGGGWRW
WGGGWGGRDGGGRGGGGWGGGGGGGGWWRGGGGGGGGGGGGGGGGGGGWWW
WGGGGWRWRGGGRGGGGWGGGGRGGGGGGRGRRGGGGGGGGGGGGGGGGRW
WGGGGGWGGRGGWWGGGWGGGGGGGGGGGRGRRGGGGGGGGGGGGGGGGWW
WGGGGGGGGWGGGGRGRWGGRGGGGGGGGGGGRGGGGGGGGGGGGGGGGGW
WGGGGGGGRGRRGGGGGGWWDGGGGRGWWDRGWGGGGGGGGGGGGDWWGGW
WDGGGGGGGGWWGGGGGGGGGRGGGGGGGGRGGWRGGGGGGGGGGRGWGRW
WRGGGGGGGGGGRGGGGGGGGRGGGGGGWWRGGGWGGGGGGGGGRGGDGRW
WRGGGGGGGGWGGGGGGGGGGRGGGGGGWWRGGGGDGGGGGGGGWGGRGWW
WRGGGGGGGGRGGGWGGGGGGRGGGGGGWGWRGGGGRGGGGGGGGDGRGWW
WRRGGGGGDGRGGGRGGGGGGRGGGGGGWGWRGGGGRGGGGGGGGGRGWWW
WGGRGGGRDGGGGGRGGGGWWRGGGGGGWGGWGGGGWGGGGGGGGGRGWWW
WGGWGGGWRGGGGGRGGGGWWRGGGGGGGGGGGGGGWWGGGGGGGGWGWWW
WRGRGRRWRGGGGGGDGGGWWRGGGGGGGGGGGGGGGWGGGGGGGGWGGGW
WGRGWRRWRGGGGGGRGGGWGWGGGGGGGGGGGGGGGWGGGGGGGGWWGDW
WWGWWGWWRGGGGGGRGGGWGWGGGGGGGGGGGGGGGWGGGGGGGGGWGGW
WGWGGGWGRGGGGGGRGGGWGWGRGGGGGGGGGGGGGWGGGGGGGGGWGGW
WGWGGGGGWRGGGGGRGGGWGWRGRWGGGGGGGGGGGGGGGGGGGGGWGGW
WWGGDGGGGWGGGGGGWGGGGGWGGRGGGGGGGGGGGGGGGGGGGGGGGGW
WWGGRGGGGGWRGGGGGGGGGGGGGRGGGGGGGGGGGGGGGGGGGGGGGGW
WWDGWGDGGGWWRGGGGGGRGGGGGGGGGGGGGGGGGWGGGGGGRGWGGGW
WGRGWWGGGGGGGRGRRGGDGGGGGGGGGGGGGGGGGGGGGGGGRDGGGGW
WRWWGGGGGGGGGRGRRGGGRGRGGGGGGWGGGGRGWGGGGGWRRGDGGGW
WWGGGGGGGGGGGGGGRGGGGGGGGWWGGWGGGGRDGGGGGGWGWGGGGGW
WRRGGGGGGGGGGGGGWGGGGGRGRGWDGDGRWGGGDGGGGGDGDGGGGGW
WWWWWWWWWWWWWWWWWWWWWWWWWWWWWWWWWWWWWWWWWWWWWWWWWWW
